__ __ __ __ __
__ __ OO __ __
__ __ __ __ __
__ CC __ __ __
__ __ __ __ __